###########
#         #
# G     . #
#         #
###########
