###########
#    g    #
# .  g  G #
#    g    #
###########