#################
#   #   #   #   #
# G g . # * b B #
#   #   #   #   #
#################
