#################
#    B  #  *    #
# .     #     G #
#       #       #
#################
