#####
# G #
#   #
# * #
#####
# . #
#   #
# B #
#####
