#################
# G #   #   #   #
#   b . # * g B #
#   #   #   #   #
#################
