###############
#       #     #
#   *   #  G  #
#       #     #
####g####     #
#       #     #
#   B   #     #
#       #  .  #
###############
