#################
#    b          #
#    b          #
#    #######gggg#
#    #     #    #
# .  # B * #    #
############    #
#          b    #
# G        b    #
#################
