################
# * #      # . #
# G #      # R #
#   #      #   #
#####      #####
#    rgbrgb    #
#    brgbrg    #
#    gbrgbr    #
#####      #####
#rgb#      # + #
#gbr#      # B #
#brg#      #   #
################
