#####################
#   #   #####   #   #
#   #    ggg  * r G #
#   #   #####   #   #
#####################
#   #   #   #   #   #
# B #   b   r   r   #
#   #   #   #   #   #
## ###r#######r###r##
##b##   #   #   #   #
##b##   r   # R g   #
##b##   #   #   #   #
## #######r##########
#   #   #   #   #   #
# . #   #   b + b   #
#   #   #   #   #   #
#####################
