#################
#   #   #   #. *#
# G #   #   # R #
#   #   #   #   #
##b###########g##
#   #   #   #   #
#   g   r   b   #
#   #   #   #   #
#################
#   #   #   #   #
#   #   # + r B #
#   #   #   #   #
#################
