#####################
#       #       #   #
#       #     * b R #
#       #       #   #
#####   ##b#######r##
#   #   #   #   #   #
#   #   #   r   #   #
#   #   #   #   #   #
##b##   ##g###g######
#   #   #   #   #   #
#   #   #   #   #   #
#   #   #   #   #   #
#gb##############   #
#   #   #   #   #   #
# B #   b + b   #   #
#   g   g   #   #   #
#####################
#   #   #   #       #
#   # . g   b  G    #
#   #   #   #       #
#####################
