#####################
#       #       b   #
#       #   B   # . #
#       #       #   #
#####   ##b########g#
#   #   #   #   #   #
#   #   #   g   #   #
#   #   #   #   #   #
#b###   ##r###r######
#   #   #   #   #   #
#   #   #   #   #   #
#   #   #   #   #   #
#rb##############   #
#   #   #   #   #   #
# * r   b G b   #   #
#   #   r   #   #   #
#####################
#   #   #   #       #
#   # R r   #   +   #
#   #   #   b       #
#####################
